2 10
5 199 851 1192 232 44
0 119 145 1233 131 33

1111111111
1000000066
1000000661
1000006601
1000066001
1000660001
1006600001
1066000001
1660000001
6611111111

33 33 33 33 33 33 33 33 33 33 
0 0 0 0 0 0 0 0 44 44 
0 0 0 0 0 0 0 44 44 0 
0 0 0 0 0 0 44 44 0 0 
0 0 0 0 0 44 44 0 0 0 
0 0 0 0 44 44 0 0 0 0 
0 0 0 44 44 0 0 0 0 0 
0 0 44 44 0 0 0 0 0 0 
0 44 44 0 0 0 0 0 0 0 
44 44 0 0 0 0 0 0 0 0 
