11111111111111111111111111111111111111111111111111
10000000000000000000000000000000000000000000000001
10000000000000000000000000000000000000000000000001
10000000000000000000000000000000000000000000000001
10000000000000000000000000000000000000000000000001
10000000000000000000000000000000000000000000000001
10000000000000000000000000000000000000000000000001
10000000000000000000000000000000000000000000000001
10000000000000000000000000000000000000000000000001
10000000000000000000000000000000000000000000000001
10000000000000000000000000000000000000000000000001
10000000000000000000000000000000000000000000000001
10000000000000000000000000000000000000000000000001
10000000000000000000000000000000000000000000000001
10000000000000000000000000000000000000000000000001
10000000000000000000000000000000000000000000000001
10000000000000000000000000000000000000000000000001
10000000000000000000000000000000000000000000000001
10000000000000000000000000000000000000000000000001
10000000000000000000000000000000000000000000000001
10000000000000000000000000000000000000000000000001
10000000000000000000000700000000000000000000000001
10000000000000000000000000000000000000000000000001
10000000000000000000000000000000000000000000000001
10000000000000000000000000000000000000000000000001
10000000000000000000000000000000000000000000000001
10000000000000000000022222200000000000000000000001
10000000000000000000010A00100000000000000000000001
10000000000000000000010000100000000000000000000001
10000000000000000000010000100000000000000000000001
10000000000000000000080000100000000000000000000001
10000000000000000000030000300000000000000000000001
10000000000000000000040000400000000000000000000001
10000000000000000000080000800000000000000000000001
10000000000000000000040000400000000000000000000001
10000000000000000000030000300000000000000000000001
10000000000000000000080000800000000000000000000001
10000000000000000000030000300000000000000000000001
10000000000000000000010000100000000000000000000001
10000000000000000000020000200000000000000000000001
10000000000000000000010000100000000000000000000001
10000000000000000000010000100000000000000000000001
10000000000000000000010000100000000000000000000001
10000000000000000000010000100000000000000000000001
100000000000000000000100P0100000000000000000000001
11111111111111111111111111111111111111111111111111

