11111111111111
12000000003021
10000000000001
100000A0000001
10002202220001
10002222220001
10002000020001
10004444440001
10000000000001
10000000000001
12P20000000001
11111111111111

