111111111
100000001
100000001
100222001
100333001
100000001
100000001
100P00001
111111111

Height map:
0 0 0 0 0 0 0 0 0
0 0 0 0 0 0 0 0 0
0 0 0 0 0 0 0 0 0
0 0 0 0 0 0 0 0 0
0 0 0 0 0 0 0 0 0
100 100 100 100 100 100 100 100 100
300 300 300 300 300 300 300 300 300
0 0 0 0 0 0 0 0 0
0 0 0 0 0 0 0 0 0
