111111111111
10000A000001
100332330001
100300030001
100330330001
100000000001
10000P000001
100000000001
111111111111

